NO ./textures/005-doomhexbronze.xpm
SO ./textures/013-brownstone.xpm
WE ./textures/014-greystone.xpm
EA ./textures/023-dirt5.xpm

F 220,100,0
C 225,0,0

111111111111111111111111
100000000000000000000001
100000000000000000000001
100E00000010000000000001
100000000000000000000001
100000000000000000000001
111111111111111111111111