NO ./textures/005-doomhexbronze.xpm
SO ./textures/013-brownstone.xpm
WE ./textures/014-greystone.xpm
EA ./textures/023-dirt5.xpm

F 220,100,0
F 220,100,0
C 225,0,0

        1111111111111111111111111
        1000000000110000000000001
        1011000001110000000000001
        1001000000000000000000001
111111111011000001110000000000001
100000000011000001110111111111111
11110111111111011100000010001
11110111111111011101010010001
11000000011010101110000010001
100000000000N0001100000010001
10000000000000001101010010001
110000011101010111110111100111
11110111 1110101 101111010001
11111111 1111111 111111111111
