NO ./textures/005-doomhexbronze.xpm
SO ./textures/013-brownstone.xpm
WE ./textures/014-greystone.xpm
EA ./textures/023-dirt5.xpm

F 220,220,220
C 0,0,0

1111111111111111111111111
1E00000000000000100000001
11101110111110111101110111
10001000100000100001000101
10111011101110111011101111
10000010000010000010000001
11110111101110111101111111
10000100001000100001000001
10111101110111101110111101
10000000000010000000000001
11110111101110111101111111
10000100001000100001000001
10111101110111101110111101
10000000000010000000000001
11110111101110111101111111
10000100001000100001000001
10111101110111101110111101
10000000000010000000000001
11111111111111111111111111